tf_tg_proximal_filtered_ATF3	TF_DB/tf_tg_proximal_filtered_ATF3.txt
tf_tg_proximal_filtered_BATF	TF_DB/tf_tg_proximal_filtered_BATF.txt
tf_tg_proximal_filtered_BCL11A	TF_DB/tf_tg_proximal_filtered_BCL11A.txt
tf_tg_proximal_filtered_BCL3	TF_DB/tf_tg_proximal_filtered_BCL3.txt
tf_tg_proximal_filtered_BCLAF1	TF_DB/tf_tg_proximal_filtered_BCLAF1.txt
tf_tg_proximal_filtered_BDP1	TF_DB/tf_tg_proximal_filtered_BDP1.txt
tf_tg_proximal_filtered_BHLHE40	TF_DB/tf_tg_proximal_filtered_BHLHE40.txt
tf_tg_proximal_filtered_BRCA1	TF_DB/tf_tg_proximal_filtered_BRCA1.txt
tf_tg_proximal_filtered_BRF1	TF_DB/tf_tg_proximal_filtered_BRF1.txt
tf_tg_proximal_filtered_BRF2	TF_DB/tf_tg_proximal_filtered_BRF2.txt
tf_tg_proximal_filtered_CCNT2	TF_DB/tf_tg_proximal_filtered_CCNT2.txt
tf_tg_proximal_filtered_CEBPB	TF_DB/tf_tg_proximal_filtered_CEBPB.txt
tf_tg_proximal_filtered_CTBP2	TF_DB/tf_tg_proximal_filtered_CTBP2.txt
tf_tg_proximal_filtered_CTCFL	TF_DB/tf_tg_proximal_filtered_CTCFL.txt
tf_tg_proximal_filtered_CTCF	TF_DB/tf_tg_proximal_filtered_CTCF.txt
tf_tg_proximal_filtered_E2F1	TF_DB/tf_tg_proximal_filtered_E2F1.txt
tf_tg_proximal_filtered_E2F4	TF_DB/tf_tg_proximal_filtered_E2F4.txt
tf_tg_proximal_filtered_E2F6	TF_DB/tf_tg_proximal_filtered_E2F6.txt
tf_tg_proximal_filtered_EBF1	TF_DB/tf_tg_proximal_filtered_EBF1.txt
tf_tg_proximal_filtered_EGR1	TF_DB/tf_tg_proximal_filtered_EGR1.txt
tf_tg_proximal_filtered_ELF1	TF_DB/tf_tg_proximal_filtered_ELF1.txt
tf_tg_proximal_filtered_ELK4	TF_DB/tf_tg_proximal_filtered_ELK4.txt
tf_tg_proximal_filtered_EP300	TF_DB/tf_tg_proximal_filtered_EP300.txt
tf_tg_proximal_filtered_ESR1	TF_DB/tf_tg_proximal_filtered_ESR1.txt
tf_tg_proximal_filtered_ESRRA	TF_DB/tf_tg_proximal_filtered_ESRRA.txt
tf_tg_proximal_filtered_ETS1	TF_DB/tf_tg_proximal_filtered_ETS1.txt
tf_tg_proximal_filtered_FAM48A	TF_DB/tf_tg_proximal_filtered_FAM48A.txt
tf_tg_proximal_filtered_FOSL1	TF_DB/tf_tg_proximal_filtered_FOSL1.txt
tf_tg_proximal_filtered_FOSL2	TF_DB/tf_tg_proximal_filtered_FOSL2.txt
tf_tg_proximal_filtered_FOS	TF_DB/tf_tg_proximal_filtered_FOS.txt
tf_tg_proximal_filtered_FOXA1	TF_DB/tf_tg_proximal_filtered_FOXA1.txt
tf_tg_proximal_filtered_FOXA2	TF_DB/tf_tg_proximal_filtered_FOXA2.txt
tf_tg_proximal_filtered_GABPA	TF_DB/tf_tg_proximal_filtered_GABPA.txt
tf_tg_proximal_filtered_GATA1	TF_DB/tf_tg_proximal_filtered_GATA1.txt
tf_tg_proximal_filtered_GATA2	TF_DB/tf_tg_proximal_filtered_GATA2.txt
tf_tg_proximal_filtered_GATA3	TF_DB/tf_tg_proximal_filtered_GATA3.txt
tf_tg_proximal_filtered_GTF2B	TF_DB/tf_tg_proximal_filtered_GTF2B.txt
tf_tg_proximal_filtered_GTF2F1	TF_DB/tf_tg_proximal_filtered_GTF2F1.txt
tf_tg_proximal_filtered_HDAC2	TF_DB/tf_tg_proximal_filtered_HDAC2.txt
tf_tg_proximal_filtered_HMGN3	TF_DB/tf_tg_proximal_filtered_HMGN3.txt
tf_tg_proximal_filtered_HNF4A	TF_DB/tf_tg_proximal_filtered_HNF4A.txt
tf_tg_proximal_filtered_HNF4G	TF_DB/tf_tg_proximal_filtered_HNF4G.txt
tf_tg_proximal_filtered_HSF1	TF_DB/tf_tg_proximal_filtered_HSF1.txt
tf_tg_proximal_filtered_IRF1	TF_DB/tf_tg_proximal_filtered_IRF1.txt
tf_tg_proximal_filtered_IRF3	TF_DB/tf_tg_proximal_filtered_IRF3.txt
tf_tg_proximal_filtered_IRF4	TF_DB/tf_tg_proximal_filtered_IRF4.txt
tf_tg_proximal_filtered_JUND	TF_DB/tf_tg_proximal_filtered_JUND.txt
tf_tg_proximal_filtered_JUN	TF_DB/tf_tg_proximal_filtered_JUN.txt
tf_tg_proximal_filtered_KAT2A	TF_DB/tf_tg_proximal_filtered_KAT2A.txt
tf_tg_proximal_filtered_MAFF	TF_DB/tf_tg_proximal_filtered_MAFF.txt
tf_tg_proximal_filtered_MAFK	TF_DB/tf_tg_proximal_filtered_MAFK.txt
tf_tg_proximal_filtered_MAX	TF_DB/tf_tg_proximal_filtered_MAX.txt
tf_tg_proximal_filtered_MEF2A	TF_DB/tf_tg_proximal_filtered_MEF2A.txt
tf_tg_proximal_filtered_MEF2C	TF_DB/tf_tg_proximal_filtered_MEF2C.txt
tf_tg_proximal_filtered_MXI1	TF_DB/tf_tg_proximal_filtered_MXI1.txt
tf_tg_proximal_filtered_MYC	TF_DB/tf_tg_proximal_filtered_MYC.txt
tf_tg_proximal_filtered_NANOG	TF_DB/tf_tg_proximal_filtered_NANOG.txt
tf_tg_proximal_filtered_NFE2	TF_DB/tf_tg_proximal_filtered_NFE2.txt
tf_tg_proximal_filtered_NFKB1	TF_DB/tf_tg_proximal_filtered_NFKB1.txt
tf_tg_proximal_filtered_NFYA	TF_DB/tf_tg_proximal_filtered_NFYA.txt
tf_tg_proximal_filtered_NFYB	TF_DB/tf_tg_proximal_filtered_NFYB.txt
tf_tg_proximal_filtered_NR2C2	TF_DB/tf_tg_proximal_filtered_NR2C2.txt
tf_tg_proximal_filtered_NR3C1	TF_DB/tf_tg_proximal_filtered_NR3C1.txt
tf_tg_proximal_filtered_NRF1	TF_DB/tf_tg_proximal_filtered_NRF1.txt
tf_tg_proximal_filtered_PAX5	TF_DB/tf_tg_proximal_filtered_PAX5.txt
tf_tg_proximal_filtered_PBX3	TF_DB/tf_tg_proximal_filtered_PBX3.txt
tf_tg_proximal_filtered_POLR3A	TF_DB/tf_tg_proximal_filtered_POLR3A.txt
tf_tg_proximal_filtered_POU2F2	TF_DB/tf_tg_proximal_filtered_POU2F2.txt
tf_tg_proximal_filtered_POU5F1	TF_DB/tf_tg_proximal_filtered_POU5F1.txt
tf_tg_proximal_filtered_PPARGC1A	TF_DB/tf_tg_proximal_filtered_PPARGC1A.txt
tf_tg_proximal_filtered_PRDM1	TF_DB/tf_tg_proximal_filtered_PRDM1.txt
tf_tg_proximal_filtered_RAD21	TF_DB/tf_tg_proximal_filtered_RAD21.txt
tf_tg_proximal_filtered_RDBP	TF_DB/tf_tg_proximal_filtered_RDBP.txt
tf_tg_proximal_filtered_REST	TF_DB/tf_tg_proximal_filtered_REST.txt
tf_tg_proximal_filtered_RFX5	TF_DB/tf_tg_proximal_filtered_RFX5.txt
tf_tg_proximal_filtered_RXRA	TF_DB/tf_tg_proximal_filtered_RXRA.txt
tf_tg_proximal_filtered_SETDB1	TF_DB/tf_tg_proximal_filtered_SETDB1.txt
tf_tg_proximal_filtered_SIN3A	TF_DB/tf_tg_proximal_filtered_SIN3A.txt
tf_tg_proximal_filtered_SIRT6	TF_DB/tf_tg_proximal_filtered_SIRT6.txt
tf_tg_proximal_filtered_SIX5	TF_DB/tf_tg_proximal_filtered_SIX5.txt
tf_tg_proximal_filtered_SMARCA4	TF_DB/tf_tg_proximal_filtered_SMARCA4.txt
tf_tg_proximal_filtered_SMARCB1	TF_DB/tf_tg_proximal_filtered_SMARCB1.txt
tf_tg_proximal_filtered_SMARCC1	TF_DB/tf_tg_proximal_filtered_SMARCC1.txt
tf_tg_proximal_filtered_SMARCC2	TF_DB/tf_tg_proximal_filtered_SMARCC2.txt
tf_tg_proximal_filtered_SMC3	TF_DB/tf_tg_proximal_filtered_SMC3.txt
tf_tg_proximal_filtered_SP1	TF_DB/tf_tg_proximal_filtered_SP1.txt
tf_tg_proximal_filtered_SP2	TF_DB/tf_tg_proximal_filtered_SP2.txt
tf_tg_proximal_filtered_SPI1	TF_DB/tf_tg_proximal_filtered_SPI1.txt
tf_tg_proximal_filtered_SREBF1	TF_DB/tf_tg_proximal_filtered_SREBF1.txt
tf_tg_proximal_filtered_SREBF2	TF_DB/tf_tg_proximal_filtered_SREBF2.txt
tf_tg_proximal_filtered_SRF	TF_DB/tf_tg_proximal_filtered_SRF.txt
tf_tg_proximal_filtered_STAT1	TF_DB/tf_tg_proximal_filtered_STAT1.txt
tf_tg_proximal_filtered_STAT2	TF_DB/tf_tg_proximal_filtered_STAT2.txt
tf_tg_proximal_filtered_STAT3	TF_DB/tf_tg_proximal_filtered_STAT3.txt
tf_tg_proximal_filtered_SUZ12	TF_DB/tf_tg_proximal_filtered_SUZ12.txt
tf_tg_proximal_filtered_TAF1	TF_DB/tf_tg_proximal_filtered_TAF1.txt
tf_tg_proximal_filtered_TAF7	TF_DB/tf_tg_proximal_filtered_TAF7.txt
tf_tg_proximal_filtered_TAL1	TF_DB/tf_tg_proximal_filtered_TAL1.txt
tf_tg_proximal_filtered_TBP	TF_DB/tf_tg_proximal_filtered_TBP.txt
tf_tg_proximal_filtered_TCF12	TF_DB/tf_tg_proximal_filtered_TCF12.txt
tf_tg_proximal_filtered_TCF4	TF_DB/tf_tg_proximal_filtered_TCF4.txt
tf_tg_proximal_filtered_TFAP2A	TF_DB/tf_tg_proximal_filtered_TFAP2A.txt
tf_tg_proximal_filtered_TFAP2C	TF_DB/tf_tg_proximal_filtered_TFAP2C.txt
tf_tg_proximal_filtered_TRIM28	TF_DB/tf_tg_proximal_filtered_TRIM28.txt
tf_tg_proximal_filtered_USF1	TF_DB/tf_tg_proximal_filtered_USF1.txt
tf_tg_proximal_filtered_USF2	TF_DB/tf_tg_proximal_filtered_USF2.txt
tf_tg_proximal_filtered_WRNIP1	TF_DB/tf_tg_proximal_filtered_WRNIP1.txt
tf_tg_proximal_filtered_XRCC4	TF_DB/tf_tg_proximal_filtered_XRCC4.txt
tf_tg_proximal_filtered_YY1	TF_DB/tf_tg_proximal_filtered_YY1.txt
tf_tg_proximal_filtered_ZBTB33	TF_DB/tf_tg_proximal_filtered_ZBTB33.txt
tf_tg_proximal_filtered_ZBTB7A	TF_DB/tf_tg_proximal_filtered_ZBTB7A.txt
tf_tg_proximal_filtered_ZEB1	TF_DB/tf_tg_proximal_filtered_ZEB1.txt
tf_tg_proximal_filtered_ZNF263	TF_DB/tf_tg_proximal_filtered_ZNF263.txt
tf_tg_proximal_filtered_ZNF274	TF_DB/tf_tg_proximal_filtered_ZNF274.txt
tf_tg_proximal_filtered_ZZZ3	TF_DB/tf_tg_proximal_filtered_ZZZ3.txt
